╔═══════                       
║↓← ← ←  ♦ ◙ ◘ ☼ $ ☺ ☻ ♥ ¼ ½ ¾   
╠↓╦═╦═╦═╦═╦═╦═╦═╦═╦═╦═╦═╦═╦═╦═╗
║↓║   ║   ║       ║ ║   ║   ║ ║
╠↓╬ ╬ ╬ ╬ ╬ ╬ ╬ ╬ ╬ ╬ ╬ ╬ ╬ ╬ ╣
║↓║ ║ ║ ║ ║ ║   ║ ║ ║ ║ ║   ║ ║
╠ ╬ ╬ ╬ ╬ ╬ ╬ ╬ ╬ ╬ ╬ ╬ ╬ ╬ ╬ ╣
║   ║ ║ ║ ║ ║   ║ ║ ║ ║   ║   ║
╠ ╬ ╬ ╬ ╬ ╬ ╬ ╬ ╬ ╬ ╬ ╬ ╬ ╬ ╬ ╣
║     ║ ║   ║   ║ ║ ║ ║   ║   ║
╠ ╬ ╬ ╬ ╬ ╬ ╬ ╬ ╬ ╬ ╬ ╬ ╬ ╬ ╬ ╣
║ ║     ║       ║ ║ ║ ║   ║   ║
╠ ╬ ╬ ╬ ╬ ╬ ╬ ╬ ╬ ╬ ╬ ╬ ╬ ╬ ╬ ╣
║   ║     ║   ║ ║   ║     ║   ║
╠ ╬ ╬ ╬ ╬ ╬ ╬ ╬ ╬ ╬ ╬ ╬ ╬ ╬ ╬ ╣
║–––– ║–––║ ║ ║–––––––––––––║ ║
╠ ╬ ╬ ╬ ╬ ╬ ╬ ╬ ╬ ╬ ╬ ╬ ╬ ╬ ╬ ╣
║       ║ ║ ║ ║     ║     ║ ║ ║
╠ ╬ ╬ ╬ ╬ ╬ ╬ ╬ ╬ ╬ ╬ ╬ ╬ ╬ ╬ ╣
║         ║ ║ ║   ║ ║   ║   ║ ║
╠ ╬ ╬ ╬ ╬ ╬ ╬ ╬ ╬ ╬ ╬ ╬ ╬ ╬ ╬ ╣
║ ║   ║   ║ ║ ║   ║         ║ ║
╠ ╬ ╬ ╬ ╬ ╬ ╬ ╬ ╬ ╬ ╬ ╬ ╬ ╬ ╬ ╣
║ ║ ║ ║ ║ ║ ║ ║             ║ ║
╠ ╬ ╬ ╬ ╬ ╬ ╬ ╬ ╬ ╬ ╬ ╬ ╬ ╬ ╬ ╣
║ ║ ║ ║ ║ ║ ║ ║   ║ ║       ║↓║
╠ ╬ ╬ ╬ ╬ ╬ ╬ ╬ ╬ ╬ ╬ ╬ ╬ ╬ ╬↓╣
║   ║   ║   ║   ║   ║       ║↓║
╚═╩═╩═╩═╩═╩═╩═╩═╩═╩═╩═╩═╩═╩═╩↓╣
                        ← ← ← ║
                       ═══════╝