************************
*■**************#####***
*#********###!###***!***
*#********#*****#***!***
*###!!!!**#*****#***#***
***#***#**!*****#####***
***#***#**!*****#***#***
***#***#**!**#**###!!***
***#***#**#**#**#***#***
***!***#**#**#**#***#***
***#***####**#**##**#***
**##****#****#***#**#***
*##*****##!###***##!##%*
************************